GEO.id,GEO.id2,GEO.display-label,HD01_VD01,HD02_VD01,HD01_VD02,HD02_VD02,HD01_VD03,HD02_VD03,HD01_VD04,HD02_VD04,HD01_VD05,HD02_VD05,HD01_VD06,HD02_VD06,HD01_VD07,HD02_VD07
1400000US29510101100,29510101100,"Census Tract 1011, St. Louis city, Missouri",2161,182,1359,123,1359,123,1303,121,56,36,0,11,802,129
1400000US29510101200,29510101200,"Census Tract 1012, St. Louis city, Missouri",2647,234,1900,219,1900,219,1732,231,168,80,0,11,747,127
1400000US29510101300,29510101300,"Census Tract 1013, St. Louis city, Missouri",3458,289,2416,261,2416,261,2166,244,250,133,0,11,1042,216
1400000US29510101400,29510101400,"Census Tract 1014, St. Louis city, Missouri",2233,204,1392,232,1392,232,1260,227,132,73,0,11,841,170
1400000US29510101500,29510101500,"Census Tract 1015, St. Louis city, Missouri",2643,351,1859,301,1859,301,1575,258,284,155,0,11,784,169
1400000US29510101800,29510101800,"Census Tract 1018, St. Louis city, Missouri",2537,284,1688,255,1672,258,1339,206,333,165,16,27,849,203
1400000US29510102100,29510102100,"Census Tract 1021, St. Louis city, Missouri",2400,208,1736,211,1736,211,1623,192,113,66,0,11,664,140
1400000US29510102200,29510102200,"Census Tract 1022, St. Louis city, Missouri",5589,333,4160,358,4160,358,3988,366,172,69,0,15,1429,210
1400000US29510102300,29510102300,"Census Tract 1023, St. Louis city, Missouri",1622,141,1104,106,1104,106,1010,107,94,46,0,11,518,143
1400000US29510102400,29510102400,"Census Tract 1024, St. Louis city, Missouri",2090,174,1568,154,1568,154,1376,166,192,97,0,11,522,142
1400000US29510102500,29510102500,"Census Tract 1025, St. Louis city, Missouri",1684,133,1235,144,1235,144,1131,141,104,53,0,11,449,91
1400000US29510103100,29510103100,"Census Tract 1031, St. Louis city, Missouri",2657,200,1933,158,1933,158,1862,158,71,49,0,11,724,226
1400000US29510103400,29510103400,"Census Tract 1034, St. Louis city, Missouri",1582,104,1193,93,1193,93,1141,98,52,32,0,11,389,64
1400000US29510103600,29510103600,"Census Tract 1036, St. Louis city, Missouri",1094,114,791,87,791,87,745,85,46,27,0,11,303,63
1400000US29510103700,29510103700,"Census Tract 1037, St. Louis city, Missouri",2047,184,1590,186,1590,186,1504,190,86,44,0,11,457,84
1400000US29510103800,29510103800,"Census Tract 1038, St. Louis city, Missouri",3274,197,2497,191,2497,191,2362,186,135,60,0,11,777,115
1400000US29510104200,29510104200,"Census Tract 1042, St. Louis city, Missouri",3097,264,2413,209,2413,209,2318,212,95,62,0,11,684,166
1400000US29510104500,29510104500,"Census Tract 1045, St. Louis city, Missouri",1482,224,1171,208,1171,208,1089,190,82,53,0,11,311,69
1400000US29510105198,29510105198,"Census Tract 1051.98, St. Louis city, Missouri",3185,320,2220,306,2220,306,2102,301,118,72,0,11,965,236
1400000US29510105200,29510105200,"Census Tract 1052, St. Louis city, Missouri",2630,243,1865,226,1865,226,1703,210,162,77,0,11,765,138
1400000US29510105300,29510105300,"Census Tract 1053, St. Louis city, Missouri",1958,269,1088,213,1088,213,881,198,207,89,0,11,870,182
1400000US29510105400,29510105400,"Census Tract 1054, St. Louis city, Missouri",1604,227,912,146,912,146,772,135,140,53,0,11,692,135
1400000US29510105500,29510105500,"Census Tract 1055, St. Louis city, Missouri",2365,287,1476,272,1476,272,1249,256,227,115,0,11,889,165
1400000US29510106100,29510106100,"Census Tract 1061, St. Louis city, Missouri",1398,178,644,129,644,129,444,96,200,80,0,11,754,136
1400000US29510106200,29510106200,"Census Tract 1062, St. Louis city, Missouri",1199,189,605,154,605,154,384,112,221,86,0,11,594,134
1400000US29510106300,29510106300,"Census Tract 1063, St. Louis city, Missouri",1106,168,547,125,547,125,406,97,141,72,0,11,559,123
1400000US29510106400,29510106400,"Census Tract 1064, St. Louis city, Missouri",1940,242,1192,178,1192,178,811,171,381,132,0,11,748,139
1400000US29510106500,29510106500,"Census Tract 1065, St. Louis city, Missouri",2438,325,1239,174,1239,174,981,166,258,85,0,11,1199,252
1400000US29510106600,29510106600,"Census Tract 1066, St. Louis city, Missouri",1337,189,726,133,726,133,465,95,261,110,0,11,611,134
1400000US29510106700,29510106700,"Census Tract 1067, St. Louis city, Missouri",2379,449,1221,250,1221,250,939,236,282,127,0,11,1158,353
1400000US29510107200,29510107200,"Census Tract 1072, St. Louis city, Missouri",871,142,454,106,430,103,405,104,25,24,24,22,417,105
1400000US29510107300,29510107300,"Census Tract 1073, St. Louis city, Missouri",4033,327,2138,284,2104,280,1617,241,487,132,34,53,1895,253
1400000US29510107400,29510107400,"Census Tract 1074, St. Louis city, Missouri",2078,245,1091,194,1091,194,711,158,380,116,0,11,987,151
1400000US29510107500,29510107500,"Census Tract 1075, St. Louis city, Missouri",2016,269,1163,254,1163,254,871,221,292,153,0,11,853,175
1400000US29510107600,29510107600,"Census Tract 1076, St. Louis city, Missouri",1764,167,1056,130,1056,130,831,137,225,82,0,11,708,124
1400000US29510108100,29510108100,"Census Tract 1081, St. Louis city, Missouri",2436,376,1339,179,1339,179,1002,197,337,154,0,11,1097,355
1400000US29510108200,29510108200,"Census Tract 1082, St. Louis city, Missouri",2137,217,936,190,936,190,749,150,187,108,0,11,1201,161
1400000US29510108300,29510108300,"Census Tract 1083, St. Louis city, Missouri",1683,182,1089,163,1089,163,872,174,217,91,0,11,594,117
1400000US29510109600,29510109600,"Census Tract 1096, St. Louis city, Missouri",2523,382,1297,254,1297,254,1016,216,281,127,0,11,1226,271
1400000US29510109700,29510109700,"Census Tract 1097, St. Louis city, Missouri",1556,188,945,154,945,154,737,136,208,81,0,11,611,123
1400000US29510110100,29510110100,"Census Tract 1101, St. Louis city, Missouri",2342,347,1335,309,1335,309,957,225,378,206,0,11,1007,217
1400000US29510110200,29510110200,"Census Tract 1102, St. Louis city, Missouri",1818,315,905,210,905,210,632,151,273,113,0,11,913,196
1400000US29510110300,29510110300,"Census Tract 1103, St. Louis city, Missouri",1702,287,1093,244,1093,244,839,195,254,121,0,11,609,125
1400000US29510110400,29510110400,"Census Tract 1104, St. Louis city, Missouri",1786,203,1041,176,1041,176,866,164,175,95,0,11,745,156
1400000US29510110500,29510110500,"Census Tract 1105, St. Louis city, Missouri",825,112,376,72,376,72,268,58,108,42,0,11,449,72
1400000US29510111100,29510111100,"Census Tract 1111, St. Louis city, Missouri",1436,214,833,192,833,192,484,129,349,122,0,11,603,141
1400000US29510111200,29510111200,"Census Tract 1112, St. Louis city, Missouri",811,142,445,89,445,89,324,75,121,62,0,11,366,91
1400000US29510111300,29510111300,"Census Tract 1113, St. Louis city, Missouri",1190,180,615,142,615,142,416,128,199,101,0,11,575,104
1400000US29510111400,29510111400,"Census Tract 1114, St. Louis city, Missouri",976,204,542,176,542,176,408,130,134,68,0,11,434,111
1400000US29510111500,29510111500,"Census Tract 1115, St. Louis city, Missouri",446,71,208,68,208,68,192,63,16,19,0,11,238,87
1400000US29510112100,29510112100,"Census Tract 1121, St. Louis city, Missouri",3902,439,2859,444,2859,444,2761,440,98,61,0,11,1043,210
1400000US29510112200,29510112200,"Census Tract 1122, St. Louis city, Missouri",1222,156,809,132,809,132,619,123,190,83,0,11,413,92
1400000US29510112300,29510112300,"Census Tract 1123, St. Louis city, Missouri",1486,291,762,165,762,165,539,139,223,69,0,11,724,224
1400000US29510112400,29510112400,"Census Tract 1124, St. Louis city, Missouri",3952,324,2720,326,2720,326,2492,334,228,114,0,11,1232,229
1400000US29510113500,29510113500,"Census Tract 1135, St. Louis city, Missouri",2001,161,1452,150,1452,150,1346,135,106,48,0,11,549,128
1400000US29510114101,29510114101,"Census Tract 1141.01, St. Louis city, Missouri",3734,380,3006,333,3006,333,2725,357,281,146,0,11,728,204
1400000US29510114102,29510114102,"Census Tract 1141.02, St. Louis city, Missouri",3320,235,2466,261,2466,261,2368,243,98,71,0,11,854,195
1400000US29510114200,29510114200,"Census Tract 1142, St. Louis city, Missouri",4057,283,3259,307,3259,307,3135,327,124,79,0,11,798,159
1400000US29510114300,29510114300,"Census Tract 1143, St. Louis city, Missouri",4476,295,3524,274,3524,274,3435,287,89,65,0,15,952,178
1400000US29510115100,29510115100,"Census Tract 1151, St. Louis city, Missouri",3459,366,2051,321,2051,321,1874,322,177,72,0,11,1408,213
1400000US29510115200,29510115200,"Census Tract 1152, St. Louis city, Missouri",2493,180,1713,200,1713,200,1559,188,154,80,0,11,780,152
1400000US29510115300,29510115300,"Census Tract 1153, St. Louis city, Missouri",4053,390,2800,338,2800,338,2569,326,231,110,0,15,1253,225
1400000US29510115400,29510115400,"Census Tract 1154, St. Louis city, Missouri",2568,305,1799,269,1799,269,1547,271,252,125,0,11,769,188
1400000US29510115500,29510115500,"Census Tract 1155, St. Louis city, Missouri",5704,637,3331,588,3331,588,2738,483,593,396,0,15,2373,509
1400000US29510115600,29510115600,"Census Tract 1156, St. Louis city, Missouri",3709,383,1700,323,1700,323,1516,325,184,121,0,11,2009,311
1400000US29510115700,29510115700,"Census Tract 1157, St. Louis city, Missouri",2669,266,1673,262,1673,262,1423,231,250,122,0,11,996,217
1400000US29510116100,29510116100,"Census Tract 1161, St. Louis city, Missouri",2755,313,2035,308,2035,308,1758,279,277,121,0,11,720,164
1400000US29510116200,29510116200,"Census Tract 1162, St. Louis city, Missouri",3580,292,2806,299,2806,299,2618,303,188,139,0,11,774,160
1400000US29510116301,29510116301,"Census Tract 1163.01, St. Louis city, Missouri",2857,244,2168,244,2168,244,2020,249,148,84,0,11,689,163
1400000US29510116302,29510116302,"Census Tract 1163.02, St. Louis city, Missouri",2134,288,1319,213,1319,213,1077,191,242,131,0,11,815,188
1400000US29510116400,29510116400,"Census Tract 1164, St. Louis city, Missouri",3800,508,2440,379,2440,379,1817,378,623,188,0,11,1360,383
1400000US29510116500,29510116500,"Census Tract 1165, St. Louis city, Missouri",3671,419,2724,352,2724,352,2345,358,379,140,0,11,947,230
1400000US29510117100,29510117100,"Census Tract 1171, St. Louis city, Missouri",1336,128,1115,121,1115,121,1100,121,15,13,0,11,221,64
1400000US29510117200,29510117200,"Census Tract 1172, St. Louis city, Missouri",4552,402,3334,291,3334,291,3157,294,177,121,0,15,1218,271
1400000US29510117400,29510117400,"Census Tract 1174, St. Louis city, Missouri",3571,341,2419,266,2419,266,2229,241,190,101,0,11,1152,232
1400000US29510118100,29510118100,"Census Tract 1181, St. Louis city, Missouri",959,154,699,144,699,144,649,134,50,30,0,11,260,79
1400000US29510118400,29510118400,"Census Tract 1184, St. Louis city, Missouri",1557,317,484,187,484,187,439,159,45,39,0,11,1073,204
1400000US29510118600,29510118600,"Census Tract 1186, St. Louis city, Missouri",3453,364,1749,251,1749,251,1573,251,176,78,0,11,1704,245
1400000US29510119101,29510119101,"Census Tract 1191.01, St. Louis city, Missouri",2475,211,1311,168,1298,164,1176,152,122,86,13,20,1164,243
1400000US29510119102,29510119102,"Census Tract 1191.02, St. Louis city, Missouri",3139,309,1868,258,1868,258,1784,256,84,52,0,11,1271,234
1400000US29510119200,29510119200,"Census Tract 1192, St. Louis city, Missouri",1578,215,975,150,975,150,877,142,98,57,0,11,603,139
1400000US29510119300,29510119300,"Census Tract 1193, St. Louis city, Missouri",4096,506,1711,306,1711,306,1531,283,180,83,0,11,2385,320
1400000US29510120200,29510120200,"Census Tract 1202, St. Louis city, Missouri",1023,166,553,140,553,140,400,113,153,84,0,11,470,107
1400000US29510121100,29510121100,"Census Tract 1211, St. Louis city, Missouri",1567,208,745,130,745,130,646,131,99,53,0,11,822,146
1400000US29510121200,29510121200,"Census Tract 1212, St. Louis city, Missouri",1454,173,787,149,787,149,593,127,194,64,0,11,667,119
1400000US29510123100,29510123100,"Census Tract 1231, St. Louis city, Missouri",2776,276,2014,238,2014,238,1843,218,171,91,0,11,762,163
1400000US29510123200,29510123200,"Census Tract 1232, St. Louis city, Missouri",1926,162,1436,144,1436,144,1368,138,68,71,0,11,490,99
1400000US29510123300,29510123300,"Census Tract 1233, St. Louis city, Missouri",2476,192,2104,178,2097,179,1996,185,101,64,7,10,372,96
1400000US29510124100,29510124100,"Census Tract 1241, St. Louis city, Missouri",3553,405,2172,357,2172,357,1902,309,270,130,0,15,1381,304
1400000US29510124200,29510124200,"Census Tract 1242, St. Louis city, Missouri",2375,382,1704,359,1704,359,1496,355,208,89,0,11,671,153
1400000US29510124300,29510124300,"Census Tract 1243, St. Louis city, Missouri",2640,219,1827,214,1820,214,1667,217,153,76,7,10,813,154
1400000US29510124600,29510124600,"Census Tract 1246, St. Louis city, Missouri",1393,139,809,120,809,120,586,96,223,78,0,11,584,117
1400000US29510125500,29510125500,"Census Tract 1255, St. Louis city, Missouri",2745,294,2260,251,2234,252,2188,260,46,47,26,32,485,191
1400000US29510125600,29510125600,"Census Tract 1256, St. Louis city, Missouri",3974,422,2875,370,2831,369,2596,391,235,147,44,42,1099,212
1400000US29510125700,29510125700,"Census Tract 1257, St. Louis city, Missouri",2394,302,1278,292,1278,292,942,257,336,138,0,11,1116,230
1400000US29510126600,29510126600,"Census Tract 1266, St. Louis city, Missouri",2388,316,1250,228,1250,228,1031,169,219,123,0,11,1138,219
1400000US29510126700,29510126700,"Census Tract 1267, St. Louis city, Missouri",966,175,471,127,471,127,368,113,103,50,0,11,495,106
1400000US29510126800,29510126800,"Census Tract 1268, St. Louis city, Missouri",3046,184,2250,213,2250,213,2184,210,66,37,0,11,796,124
1400000US29510126900,29510126900,"Census Tract 1269, St. Louis city, Missouri",3590,332,1858,248,1858,248,1129,196,729,191,0,11,1732,268
1400000US29510127000,29510127000,"Census Tract 1270, St. Louis city, Missouri",1849,213,648,151,648,151,492,123,156,82,0,11,1201,190
1400000US29510127100,29510127100,"Census Tract 1271, St. Louis city, Missouri",1601,206,753,134,753,134,561,125,192,69,0,11,848,155
1400000US29510127200,29510127200,"Census Tract 1272, St. Louis city, Missouri",3824,479,2614,437,2614,437,2529,444,85,47,0,11,1210,255
1400000US29510127300,29510127300,"Census Tract 1273, St. Louis city, Missouri",2905,301,1897,281,1897,281,1663,211,234,143,0,11,1008,158
1400000US29510127400,29510127400,"Census Tract 1274, St. Louis city, Missouri",3791,316,2382,369,2382,369,1918,377,464,214,0,15,1409,265
1400000US29510127500,29510127500,"Census Tract 1275, St. Louis city, Missouri",1977,197,1379,178,1379,178,1124,162,255,101,0,11,598,125
1400000US29510127600,29510127600,"Census Tract 1276, St. Louis city, Missouri",2913,267,2415,287,2411,287,2318,279,93,52,4,7,498,140