GEO.id,GEO.id2,GEO.display-label,HD01_VD01,HD02_VD01,HD01_VD02,HD02_VD02,HD01_VD03,HD02_VD03
1400000US29510101100,29510101100,"Census Tract 1011, St. Louis city, Missouri",54,43,28,46,26,32
1400000US29510101200,29510101200,"Census Tract 1012, St. Louis city, Missouri",20,25,20,25,0,11
1400000US29510101300,29510101300,"Census Tract 1013, St. Louis city, Missouri",174,116,44,50,130,108
1400000US29510101400,29510101400,"Census Tract 1014, St. Louis city, Missouri",264,64,133,36,131,73
1400000US29510101500,29510101500,"Census Tract 1015, St. Louis city, Missouri",411,131,71,58,340,135
1400000US29510101800,29510101800,"Census Tract 1018, St. Louis city, Missouri",350,82,69,37,281,98
1400000US29510102100,29510102100,"Census Tract 1021, St. Louis city, Missouri",99,57,0,11,99,57
1400000US29510102200,29510102200,"Census Tract 1022, St. Louis city, Missouri",35,39,21,34,14,21
1400000US29510102300,29510102300,"Census Tract 1023, St. Louis city, Missouri",17,21,0,11,17,21
1400000US29510102400,29510102400,"Census Tract 1024, St. Louis city, Missouri",46,34,21,20,25,27
1400000US29510102500,29510102500,"Census Tract 1025, St. Louis city, Missouri",49,39,0,11,49,39
1400000US29510103100,29510103100,"Census Tract 1031, St. Louis city, Missouri",257,151,11,16,246,150
1400000US29510103400,29510103400,"Census Tract 1034, St. Louis city, Missouri",12,14,6,9,6,9
1400000US29510103600,29510103600,"Census Tract 1036, St. Louis city, Missouri",17,26,0,11,17,26
1400000US29510103700,29510103700,"Census Tract 1037, St. Louis city, Missouri",48,50,9,14,39,49
1400000US29510103800,29510103800,"Census Tract 1038, St. Louis city, Missouri",137,95,11,17,126,94
1400000US29510104200,29510104200,"Census Tract 1042, St. Louis city, Missouri",79,57,24,22,55,51
1400000US29510104500,29510104500,"Census Tract 1045, St. Louis city, Missouri",75,61,3,7,72,59
1400000US29510105198,29510105198,"Census Tract 1051.98, St. Louis city, Missouri",243,115,107,57,136,108
1400000US29510105200,29510105200,"Census Tract 1052, St. Louis city, Missouri",684,103,282,62,402,103
1400000US29510105300,29510105300,"Census Tract 1053, St. Louis city, Missouri",1003,123,342,95,661,113
1400000US29510105400,29510105400,"Census Tract 1054, St. Louis city, Missouri",712,87,90,30,622,90
1400000US29510105500,29510105500,"Census Tract 1055, St. Louis city, Missouri",1014,124,519,112,495,117
1400000US29510106100,29510106100,"Census Tract 1061, St. Louis city, Missouri",776,83,272,54,504,82
1400000US29510106200,29510106200,"Census Tract 1062, St. Louis city, Missouri",615,76,218,58,397,80
1400000US29510106300,29510106300,"Census Tract 1063, St. Louis city, Missouri",540,76,264,61,276,74
1400000US29510106400,29510106400,"Census Tract 1064, St. Louis city, Missouri",970,115,398,85,572,123
1400000US29510106500,29510106500,"Census Tract 1065, St. Louis city, Missouri",1112,122,448,109,664,139
1400000US29510106600,29510106600,"Census Tract 1066, St. Louis city, Missouri",630,79,214,57,416,74
1400000US29510106700,29510106700,"Census Tract 1067, St. Louis city, Missouri",1336,147,558,132,778,144
1400000US29510107200,29510107200,"Census Tract 1072, St. Louis city, Missouri",456,82,215,43,241,75
1400000US29510107300,29510107300,"Census Tract 1073, St. Louis city, Missouri",1766,135,993,128,773,161
1400000US29510107400,29510107400,"Census Tract 1074, St. Louis city, Missouri",897,92,504,83,393,90
1400000US29510107500,29510107500,"Census Tract 1075, St. Louis city, Missouri",855,132,522,90,333,127
1400000US29510107600,29510107600,"Census Tract 1076, St. Louis city, Missouri",863,78,456,77,407,94
1400000US29510108100,29510108100,"Census Tract 1081, St. Louis city, Missouri",1079,111,561,91,518,117
1400000US29510108200,29510108200,"Census Tract 1082, St. Louis city, Missouri",1049,100,638,90,411,107
1400000US29510108300,29510108300,"Census Tract 1083, St. Louis city, Missouri",803,81,459,81,344,77
1400000US29510109600,29510109600,"Census Tract 1096, St. Louis city, Missouri",1211,146,621,119,590,181
1400000US29510109700,29510109700,"Census Tract 1097, St. Louis city, Missouri",727,114,263,57,464,106
1400000US29510110100,29510110100,"Census Tract 1101, St. Louis city, Missouri",1127,139,468,118,659,141
1400000US29510110200,29510110200,"Census Tract 1102, St. Louis city, Missouri",939,122,381,97,558,120
1400000US29510110300,29510110300,"Census Tract 1103, St. Louis city, Missouri",859,139,296,79,563,137
1400000US29510110400,29510110400,"Census Tract 1104, St. Louis city, Missouri",973,104,447,92,526,134
1400000US29510110500,29510110500,"Census Tract 1105, St. Louis city, Missouri",440,59,214,42,226,56
1400000US29510111100,29510111100,"Census Tract 1111, St. Louis city, Missouri",593,70,245,56,348,78
1400000US29510111200,29510111200,"Census Tract 1112, St. Louis city, Missouri",357,74,159,49,198,72
1400000US29510111300,29510111300,"Census Tract 1113, St. Louis city, Missouri",739,95,183,49,556,96
1400000US29510111400,29510111400,"Census Tract 1114, St. Louis city, Missouri",447,83,213,64,234,67
1400000US29510111500,29510111500,"Census Tract 1115, St. Louis city, Missouri",211,38,86,47,125,37
1400000US29510112100,29510112100,"Census Tract 1121, St. Louis city, Missouri",616,189,133,88,483,191
1400000US29510112200,29510112200,"Census Tract 1122, St. Louis city, Missouri",619,70,214,56,405,72
1400000US29510112300,29510112300,"Census Tract 1123, St. Louis city, Missouri",777,105,236,55,541,89
1400000US29510112400,29510112400,"Census Tract 1124, St. Louis city, Missouri",465,169,28,24,437,178
1400000US29510113500,29510113500,"Census Tract 1135, St. Louis city, Missouri",8,13,0,11,8,13
1400000US29510114101,29510114101,"Census Tract 1141.01, St. Louis city, Missouri",446,184,45,47,401,178
1400000US29510114102,29510114102,"Census Tract 1141.02, St. Louis city, Missouri",90,97,0,11,90,97
1400000US29510114200,29510114200,"Census Tract 1142, St. Louis city, Missouri",312,137,60,53,252,133
1400000US29510114300,29510114300,"Census Tract 1143, St. Louis city, Missouri",51,53,29,43,22,35
1400000US29510115100,29510115100,"Census Tract 1151, St. Louis city, Missouri",117,66,11,16,106,67
1400000US29510115200,29510115200,"Census Tract 1152, St. Louis city, Missouri",642,114,19,23,623,119
1400000US29510115300,29510115300,"Census Tract 1153, St. Louis city, Missouri",540,117,139,63,401,125
1400000US29510115400,29510115400,"Census Tract 1154, St. Louis city, Missouri",286,108,84,66,202,98
1400000US29510115500,29510115500,"Census Tract 1155, St. Louis city, Missouri",1016,219,267,125,749,227
1400000US29510115600,29510115600,"Census Tract 1156, St. Louis city, Missouri",969,184,91,74,878,186
1400000US29510115700,29510115700,"Census Tract 1157, St. Louis city, Missouri",562,138,141,74,421,139
1400000US29510116100,29510116100,"Census Tract 1161, St. Louis city, Missouri",346,94,189,72,157,70
1400000US29510116200,29510116200,"Census Tract 1162, St. Louis city, Missouri",412,144,73,62,339,157
1400000US29510116301,29510116301,"Census Tract 1163.01, St. Louis city, Missouri",252,116,40,29,212,119
1400000US29510116302,29510116302,"Census Tract 1163.02, St. Louis city, Missouri",551,136,121,67,430,139
1400000US29510116400,29510116400,"Census Tract 1164, St. Louis city, Missouri",1000,130,282,115,718,157
1400000US29510116500,29510116500,"Census Tract 1165, St. Louis city, Missouri",820,148,168,80,652,144
1400000US29510117100,29510117100,"Census Tract 1171, St. Louis city, Missouri",174,59,29,15,145,58
1400000US29510117200,29510117200,"Census Tract 1172, St. Louis city, Missouri",962,185,456,146,506,184
1400000US29510117400,29510117400,"Census Tract 1174, St. Louis city, Missouri",570,142,149,64,421,133
1400000US29510118100,29510118100,"Census Tract 1181, St. Louis city, Missouri",285,55,58,27,227,56
1400000US29510118400,29510118400,"Census Tract 1184, St. Louis city, Missouri",281,57,0,11,281,57
1400000US29510118600,29510118600,"Census Tract 1186, St. Louis city, Missouri",522,116,140,79,382,116
1400000US29510119101,29510119101,"Census Tract 1191.01, St. Louis city, Missouri",664,122,89,40,575,135
1400000US29510119102,29510119102,"Census Tract 1191.02, St. Louis city, Missouri",207,62,83,33,124,61
1400000US29510119200,29510119200,"Census Tract 1192, St. Louis city, Missouri",506,80,239,61,267,59
1400000US29510119300,29510119300,"Census Tract 1193, St. Louis city, Missouri",616,110,12,17,604,109
1400000US29510120200,29510120200,"Census Tract 1202, St. Louis city, Missouri",392,63,130,43,262,61
1400000US29510121100,29510121100,"Census Tract 1211, St. Louis city, Missouri",830,84,7,10,823,84
1400000US29510121200,29510121200,"Census Tract 1212, St. Louis city, Missouri",924,92,63,39,861,102
1400000US29510123100,29510123100,"Census Tract 1231, St. Louis city, Missouri",988,125,438,101,550,125
1400000US29510123200,29510123200,"Census Tract 1232, St. Louis city, Missouri",409,90,23,23,386,88
1400000US29510123300,29510123300,"Census Tract 1233, St. Louis city, Missouri",403,108,94,61,309,103
1400000US29510124100,29510124100,"Census Tract 1241, St. Louis city, Missouri",1055,169,274,91,781,154
1400000US29510124200,29510124200,"Census Tract 1242, St. Louis city, Missouri",669,122,114,62,555,121
1400000US29510124300,29510124300,"Census Tract 1243, St. Louis city, Missouri",237,60,68,43,169,69
1400000US29510124600,29510124600,"Census Tract 1246, St. Louis city, Missouri",409,57,60,28,349,60
1400000US29510125500,29510125500,"Census Tract 1255, St. Louis city, Missouri",614,133,68,59,546,125
1400000US29510125600,29510125600,"Census Tract 1256, St. Louis city, Missouri",993,226,0,11,993,226
1400000US29510125700,29510125700,"Census Tract 1257, St. Louis city, Missouri",1415,129,70,51,1345,131
1400000US29510126600,29510126600,"Census Tract 1266, St. Louis city, Missouri",974,131,184,70,790,136
1400000US29510126700,29510126700,"Census Tract 1267, St. Louis city, Missouri",295,71,90,49,205,61
1400000US29510126800,29510126800,"Census Tract 1268, St. Louis city, Missouri",103,48,40,30,63,37
1400000US29510126900,29510126900,"Census Tract 1269, St. Louis city, Missouri",1666,145,1082,135,584,150
1400000US29510127000,29510127000,"Census Tract 1270, St. Louis city, Missouri",519,99,100,49,419,99
1400000US29510127100,29510127100,"Census Tract 1271, St. Louis city, Missouri",818,87,236,59,582,90
1400000US29510127200,29510127200,"Census Tract 1272, St. Louis city, Missouri",328,158,66,51,262,154
1400000US29510127300,29510127300,"Census Tract 1273, St. Louis city, Missouri",962,122,313,91,649,127
1400000US29510127400,29510127400,"Census Tract 1274, St. Louis city, Missouri",1347,168,190,91,1157,172
1400000US29510127500,29510127500,"Census Tract 1275, St. Louis city, Missouri",944,103,11,14,933,99
1400000US29510127600,29510127600,"Census Tract 1276, St. Louis city, Missouri",367,118,42,51,325,123